{
  "to_nepali": {
    "0": "०",
    "1": "१",
    "2": "२",
    "3": "३",
    "4": "४",
    "5": "५",
    "6": "६",
    "7": "७",
    "8": "८",
    "9": "९"
  },
  "to_english": {
    "०": "0",
    "१": "1",
    "२": "2",
    "३": "3",
    "४": "4",
    "५": "5",
    "६": "6",
    "७": "7",
    "८": "8",
    "९": "9"
  }
}
